111111111111111111111111111111111111111111111111
100000000000000000000000000000000000000000000001
101111111111111111111110011111111111111111110001
101000000000000000000000000000000000000000010001
101000000000000000000000000000000000000000011111
101000000000000000000000000000000000000000000101
101000111111111111111110011111111111111111000101
101000100000000000000000000000000000000001000101
101000100000000000000000000000000000000001000101
101000100000000000000000000000000000000001000101
101000100011111111111110011111111111110001000101
101000100010000000000000000000000000010001000101
100000000000000000000000000000000000000000000001
100000000000000000000000000000000000000000000001
100000000000000000000000000000000000000000000001
101000100010000000000000000000000000010001000101
101000100011111111111110011111111111110001000101
101000100000000000000000000000000000000001000101
101000100000000000000000000000000000000001000101
101000100000000000000000000000000000000001000101
101000111111111111111110011111111111111111000101
101000000000000000000000000000000000000000000101
111110000000000000000000000000000000000000000101
100010000000000000000000000000000000000000000101
100011111111111111111110011111111111111111111101
100000000000000000000000000000000000000000000001
111111111111111111111111111111111111111111111111
