111111111111111111111111111111111111111111111111
100000000000000000000000000000000000000000000001
100111111111111111111110011111111111111111110001
101000000000000000000000000000000000000000010001
101000000000000000000000000000000000000000001111
101000000000000000000000000000000000000000000101
101000011111111111111110011111111111111110000101
101000100000000000000000000000000000000001000101
101000100000000000000000000000000000000001000101
101000100000000000000000000000000000000001000101
101000100001111111111110011111111111100001000101
101000100010000000000000000000000000010001000101
100000000000000000000000000000000000000000000001
100000000000010010010010010010010010000000000001
100000000000000000000000000000000000000000000001
101000100010000000000000000000000000010001000101
101000100001111111111110011111111111100001000101
101000100000000000000000000000000000000001000101
101000100000000000000000000000000000000001000101
101000100000000000000000000000000000000001000101
101000011111111111111110011111111111111110000101
101000000000000000000000000000000000000000000101
111100000000000000000000000000000000000000000101
100010000000000000000000000000000000000000000101
100011111111111111111110011111111111111111111001
100000000000000000000000000000000000000000000001
111111111111111111111111111111111111111111111111
