111111111111111111111111111111111111111111111111
100000000000000000000000000000000000000000000001
100000000000000000000000000000000000000000000001
100111111111111111111111111111111111111111110001
100100000000000000000000000000000000000000010001
100100000000000000000000000000000000000000010001
100100000000000000000000000000000000000000010001
100100000000000000000000000000000000000000010001
100100000000000000000000000000000000000000010001
100100000000000000000000000000000000000000010001
100100000000000000000000000000000000000000010001
100100000000000000000000000000000000000000010001
100000000000000000000000000000000000000000010001
100000000000000000000000000000000000000000010001
100100000000000000000000000000000000000000010001
100100000000000000000000000000000000000000010001
100100000000000000000000000000000000000000010001
100100000000000000000000000000000000000000010001
100100000000000000000000000000000000000000010001
100100000000000000000000000000000000000000010001
100100000000000000000000000000000000000000010001
100100000000000000000000000000000000000000010001
100100000000000000000000000000000000000000010001
100111111111111111111111111111111111111111110001
100000000000000000000000000000000000000000000001
100000000000000000000000000000000000000000000001
111111111111111111111111111111111111111111111111